11
11111111111
10022222001
10121212101
10220220201
12121212101
12202022201
12121212121
12002220221
10101212101
10002222001
11111111111
