11
11111111111
10000000001
10101010101
10020002001
10101010101
10000000001
10101010101
10000000001
10101010101
10000000001
11111111111
