11
11111111111
10033333001
10232323201
13333333331
13232323231
13333333331
13232323231
13333333331
10232323201
10033333001
11111111111
