13
1111111111111
1003223223001
1032332332301
1322322232231
1323332333231
1323232323231
1333233323331
1323232323231
1323332333231
1322322232231
1032332332301
1003223223001
1111111111111
